2001|2001: a space odyssey|arthur c. clarke
451|fahrenheit 451|ray bradbury
a-game-of-thrones|a game of thrones|george r. r. martin
absalom|absalom, absalom!|william faulkner
adaynopigs|a day no pigs would die|robert newton peck
afraidofwoolf|who's afraid of virginia woolf?|edward albee
africa|out of africa|isak dinesen
alas|alas, babylon|pat frank
algernon|flowers for algernon|daniel keyes
alice|alice’s adventures in wonderland|lewis carroll
allbutmylife|all but my life|gerda weissmann klein
allquiet|all quiet on the western front|erich maria remarque
allthepretty|all the pretty horses|cormac mccarthy
amanforallseasons|a man for all seasons|robert bolt
andthenthere|and then there were none|agatha christie
angelasashes|angela’s ashes|frank mccourt
animaldreams|animal dreams|barbara kingsolver
animalfarm|animal farm|george orwell
annefrank|diary of a young girl|anne frank
anniejohn|annie john|jamaica kincaid
antonia|my Ántonia|willa cather
asher|my name is asher lev|chaim potok
asilay|as i lay dying|william faulkner
assistant|the assistant|bernard malamud
atlasshrugged|atlas shrugged|ayn rand
beantrees|the bean trees|barbara kingsolver
beasts|bless the beasts and children|glendon swarthout
belcanto|bel canto|ann patchett
belljar|the bell jar|sylvia plath
belltolls|for whom the bell tolls|ernest hemingway
bigsleep|the big sleep|raymond chandler
billybudd|billy budd, sailor|herman melville
birdbybird|bird by bird|anne lamott
blackboy|black boy|richard wright
blacklikeme|black like me|john howard griffin
bluesteye|the bluest eye|toni morrison
borderpassage|a border passage|leila ahmed
bravenew|brave new world|aldous huxley
breadgivers|bread givers|anzia yezierska
breatheyes|breath, eyes, memory|edwidge danticat
brewsterplace|the women of brewster place|gloria naylor
brooklyn|a tree grows in brooklyn|betty smith
brothersam|my brother sam is dead|christopher collier & james lincoln collier
cagedbird|i know why the caged bird sings|maya angelou
cainemutiny|the caine mutiny|herman wouk
canneryrow|cannery row|john steinbeck
catch22|catch-22|joseph heller
catcher|the catcher in the rye|j. d. salinger
catching-fire|catching fire|suzanne collins
catscradle|cat's cradle|kurt vonnegut
cedars|snow falling on cedars|david guterson
changes|changes: a love story|ama ata aidoo
charlie|charlie and the chocolate factory|roald dahl
cheese|i am the cheese|robert cormier
chekhov|chekhov stories|anton chekhov
childhoodsend|childhood's end|arthur c. clarke
childofthedark|child of the dark|carolina maria de jesus
chocolatewar|the chocolate war|robert cormier
cholera|love in the time of cholera|gabriel garcía márquez
chrondeath|chronicle of a death foretold|gabriel garcía márquez
cityladies|the book of the city of ladies|christine de pizan
clockworkorange|a clockwork orange|anthony burgess
coldmountain|cold mountain|charles frazier
coldsassy|cold sassy tree|olive anne burns
colorofwater|the color of water|james mcbride
comingofage|coming of age in mississippi|anne moody
contender|the contender|robert lipsyte
crucible|the crucible|arthur miller
cry|cry, the beloved country|alan paton
cuckoo|one flew over the cuckoo’s nest|ken kesey
dalloway|mrs. dalloway|virginia woolf
dandelion|dandelion wine|ray bradbury
dangerous|dangerous liaisons|pierre ambroise laclos
davincicode|the da vinci code|dan brown
deadmanwalking|dead man walking|sister helen prejean
deathinthefamily|a death in the family|james agee
denisovich|one day in the life of ivan denisovich|alexander solzhenitsyn
diceyssong|dicey's song|cynthia voigt
distantview|distant view of a minaret|alifa rifaat
dollhouse|a doll’s house|henrik ibsen
dolphins|island of the blue dolphins|scott o'dell
eastofeden|east of eden|john steinbeck
ellenfoster|ellen foster|kaye gibbons
endersgame|ender's game|orson scott card
englishpatient|the english patient|michael ondaatje
eyes|their eyes were watching god|zora neale hurston
fallenangels|fallen angels|walter dean myers
farewell|a farewell to arms|ernest hemingway
fellowship|the fellowship of the ring|j. r. r. tolkien
fiveaprils|across five aprils|irene hunt
flies|lord of the flies|william golding
fountainhead|the fountainhead|ayn rand
franny|franny and zooey|j.d. salinger
futureking|the once and future king|t. h. white
garciagirls|how the garcia girls lost their accents|julia alvarez
gatheringofoldmen|a gathering of old men|ernest j. gaines
gatsby|the great gatsby|f. scott fitzgerald
giants|giants in the earth|o.e. rölvaag
girlinterrupted|girl, interrupted|susanna kaysen
giver|the giver|lois lowry
goaskalice|go ask alice|anonymous
godot|waiting for godot|samuel beckett
gonewith|gone with the wind|margaret mitchell
goodearth|the good earth|pearl s. buck
gotellit|go tell it on the mountain|james baldwin
grapesofwrath|the grapes of wrath|john steinbeck
grendel|grendel|john gardner
gulliver|gulliver’s travels|jonathan swift
handmaid|the handmaid’s tale|margaret atwood
harrypotter|harry potter and the sorcerer’s stone|j. k. rowling
harrypotter5|harry potter and the order of the phoenix|j.k. rowling
hatchet|hatchet|gary paulsen
havingoursay|having our say: the delany sisters’ first 100 years|sarah louise delany and annie elizabeth delany, with amy hill hearth
hisdarkmaterials|his dark materials|philip pullman
hobbit|the hobbit|j. r. r. tolkien
housedawn|house made of dawn|n. scott momaday
houseofspirits|the house of the spirits|isabel allende
incoldblood|in cold blood|truman capote
inourtime|in our time|ernest hemingway
irigoberta|i, rigoberta menchu|rigoberta menchu
ivanilych|the death of ivan ilych|leo tolstoy
johnnygun|johnny got his gun|dalton trumbo
johnnytremain|johnny tremain|esther forbes
joyluck|the joy luck club|amy tan
joysofmotherhood|the joys of motherhood|buchi emecheta
jurassicpark|jurassic park|michael crichton
killerangels|the killer angels|michael shaara
kingmustdie|the king must die|mary renault
kingsmen|all the king's men|robert penn warren
kitchengods|the kitchen god's wife|amy tan
krikkrak|krik? krak!|edwidge danticat
ladychatterley|lady chatterley's lover|d.h. lawrence
lessonbefore|a lesson before dying|ernest j. gaines
lieutenantnun|lieutenant nun|catalina de erauso
lifeofpi|life of pi|yann martel
lightforest|the light in the forest|conrad richter
lighthouse|to the lighthouse|virginia woolf
lightinaugust|light in august|william faulkner
likewater|like water for chocolate|laura esquivel
lion|the lion, the witch, and the wardrobe|c. s. lewis
locust|the day of the locust|nathanael west
lolita|lolita|vladimir nabokov
lonelyhearts|miss lonelyhearts|nathanael west
lonelyhunter|the heart is a lonely hunter|carson mccullers
longdays|long day's journey into night|eugene o'neill
lot49|the crying of lot 49|thomas pynchon
luckyjim|lucky jim|kingsley amis
lucy|lucy: a novel|jamaica kincaid
malcolmx|the autobiography of malcolm x|malcolm x & alex haley
mangostreet|the house on mango street|sandra cisneros
manzanar|farewell to manzanar|jeanne wakatsuki houston
margerykempe|the book of margery kempe|margery kempe
medievallife|a medieval life|judith bennett
melvillestories|melville stories|herman melville
memberwedding|the member of the wedding|carson mccullers
menagerie|the glass menagerie|tennessee williams
micemen|of mice and men|john steinbeck
midnightschildren|midnight’s children|salman rushdie
midwifestale|a midwife’s tale|laurel thatcher ulrich
millionlittle|a million little pieces|james frey
mirth|the house of mirth|edith wharton
missjane|the autobiography of miss jane pittman|ernest j. gaines
mobydick|moby-dick|herman melville
mocking|to kill a mockingbird|harper lee
morrie|tuesdays with morrie|mitch albom
moses|go down, moses|william faulkner
my-sisters-keeper|my sister’s keeper|jodi picoult
nausea|nausea|jean-paul sartre
nectar|nectar in a sieve|kamala markandaya
nervouscondition|nervous conditions|tsitsi dangarembga
nisa|nisa: the life and words of a !kung woman|marjorie shostak
noexit|no exit|jean-paul sartre
nolonger|no longer at ease|chinua achebe
numberthestars|number the stars|lois lowry
obasan|obasan|joy kogawa
oldman|the old man and the sea|ernest hemingway
oranges|oranges are not the only fruit|jeanette winterson
ordinarypeople|ordinary people|judith guest
orientexpress|murder on the orient express|agatha christie
outsiders|the outsiders|s. e. hinton
owenmeany|a prayer for owen meany|john irving
passage|a passage to india|e. m. forster
pigsheaven|pigs in heaven|barbara kingsolver
pilgrims|the pilgrim’s progress|john bunyan
pointzero|woman at point zero|nawal el saadawi
poisonwood|poisonwood bible|barbara kingsolver
potter2|harry potter and the chamber of secrets|j. k. rowling
potter3|harry potter and the prisoner of azkaban|j. k. rowling
potter4|harry potter and the goblet of fire|j. k. rowling
potter6|harry potter and the half-blood prince|j. k. rowling
potter7|harry potter and the deathly hallows|j. k. rowling
power|the power of one|bryce courtenay
princessbride|the princess bride|william goldman
purple|the color purple|alice walker
raisin|a raisin in the sun|lorraine hansberry
redfern|where the red fern grows|wilson rawls
redpony|the red pony|john steinbeck
remains|the remains of the day|kazuo ishiguro
returnking|the return of the king|j. r. r. tolkien
rollofthunder|roll of thunder, hear my cry|mildred d. taylor
roomofonesown|a room of one’s own|virginia woolf
rosegarden|i never promised you a rose garden|joanne greenberg
rubyfruit|rubyfruit jungle|rita mae brown
salesman|death of a salesman|arthur miller
sargasso|wide sargasso sea|jean rhys
secondsex|the second sex|simone de beauvoir
secretbees|the secret life of bees|sue monk kidd
seize|seize the day|saul bellow
separate|a separate peace|john knowles
shabanu|shabanu|suzanne fisher staples
shipping|the shipping news|annie proulx
sisterpants|the sisterhood of the traveling pants|ann brashares
slaughter|slaughterhouse-five|kurt vonnegut
smallplace|a small place|jamaica kincaid
solitude|one hundred years of solitude|gabriel garcía márquez
sophie|sophie's world|jostein gaarder
soundfury|the sound and the fury|william faulkner
sovereignty|the sovereignty and goodness of god|mary rowlandson
steppenwolf|steppenwolf|hermann hesse
strangeland|stranger in a strange land|robert a. heinlein
streetcar|a streetcar named desire|tennessee williams
sun|the sun also rises|ernest hemingway
surfacing|surfacing|margaret atwood
tender|tender is the night|f. scott fitzgerald
terabithia|bridge to terabithia|katherine paterson
tess|tess of the d’urbervilles|thomas hardy
the-book-thief|the book thief|markus zusak
the-curious-incident-of-the-dog-in-the-night-time|the curious incident of the dog in the night-time|mark haddon
the-fault-in-our-stars|the fault in our stars|john green
the-girl-with-the-dragon-tattoo|the girl with the dragon tattoo|stieg larsson
the-hunger-games|the hunger games|suzanne collins
the-kite-runner|the kite runner|khaled hosseini
things|things fall apart|chinua achebe
thingscarried|the things they carried|tim o’brien
thisboyslife|this boy's life|tobias wolff
three-cups-of-tea|three cups of tea|greg mortenson & david oliver relin
tollbooth|the phantom tollbooth|norton juster
tortillaflat|tortilla flat|john steinbeck
twilight|“twilight of the superheroes”|deborah eisenberg
twomoons|walk two moons|sharon creech
twotowers|the two towers|j. r. r. tolkien
ultima|bless me, ultima|rudolfo a. anaya
unbearablelightness|the unbearable lightness of being|milan kundera
uncletom|uncle tom’s cabin|harriet beecher stowe
underground|notes from underground|fyodor dostoevsky
unvanquished|the unvanquished|william faulkner
venice|death in venice|thomas mann
virginsuicides|virgin suicides|jeffrey eugenides
walden2|walden two|b.f. skinner
warriorsdontcry|warriors don’t cry|melba patillo beals
watership|watership down|richard adams
whenheaven|when heaven and earth changed places|le ly hayslip
whenlegends|when the legends die|hal borland
whirlwind|journey into the whirlwind|eugenia ginzburg
whitenoise|white noise|don delillo
wicked|something wicked this way comes|ray bradbury
womanwarrior|the woman warrior|maxine hong kingston
wrinkle|a wrinkle in time|madeleine l'engle
yearmagical|the year of magical thinking|joan didion
yellowraft|a yellow raft in blue water|michael dorris
zhivago|dr. zhivago|boris pasternak
