arrowsmith|arrowsmith|sinclair lewis
awakening|the awakening|kate chopin
beloved|beloved|toni morrison
blackprince|the black prince|iris murdoch
brothersk|the brothers karamazov|fyodor dostoevsky
ceremony|ceremony|leslie marmon silko
chosen|the chosen|chaim potok
clarissa|clarissa|samuel richardson
deathbenot|death be not proud|john gunther
dune|dune|frank herbert
franklinautobio|the autobiography of benjamin franklin|benjamin franklin
herzog|herzog|saul bellow
hiroshima|hiroshima|john hersey
holes|holes|louis sachar
homecoming|homecoming|cynthia voigt
hours|the hours|michael cunningham
hunchback|hunchback of notre dame|victor hugo
idiot|the idiot|fyodor dostoevsky
incidents|incidents in the life of a slave girl|harriet jacobs
invisibleman|invisible man|ralph ellison
janeeyre|jane eyre|charlotte brontë
jazz|jazz|toni morrison
kindred|kindred|octavia butler
land|the land|mildred d. taylor
legs|legs|william kennedy
lesmis|les misérables|victor hugo
meridian|meridian|alice walker
metamorph|the metamorphosis|franz kafka
mythology|mythology|edith hamilton
nativeson|native son|richard wright
natural|the natural|bernard malamud
night|night|elie wiesel
onthebeach|on the beach|nevil shute
ontheroad|on the road|jack kerouac
pearl|the pearl|john steinbeck
plague|the plague|albert camus
portraitlady|the portrait of a lady|henry james
powerglory|the power and the glory|graham greene
ragtime|ragtime|e. l. doctorow
rebecca|rebecca|daphne du maurier
regeneration|regeneration|pat barker
sentimental|sentimental education|gustave flaubert
shane|shane|jack schaefer
solomon|song of solomon|toni morrison
sounder|sounder|william armstrong
stranger|the stranger|albert camus
sula|sula|toni morrison
the-alchemist|the alchemist|paulo coelho
tomjones|tom jones|henry fielding
tomsawyer|the adventures of tom sawyer|mark twain
tristram|tristram shandy|laurence sterne
walden|walden|henry david thoreau
waves|the waves|virginia woolf
yankee|a connecticut yankee in king arthur's court|mark twain
